1117777777777111
1160000000000511
1600000000000051
1000000000000001
1000000000000001
1000000000000001
1000000000000001
1000000000000001
1000000423000001
1000020111000001
1000000576000001
1002000000000001
1000000000000001
1300000000000041
11300000-0000411
1112222222222111
